name=Test Map [2]
description=Testing Purposes Only
numPlayers=2
[mapDetails]
width=25
height=25
wraps=false
r0sx=21
r0sy=13
r1sx=4
r1sy=11
t000="                         "
t001="                         "
t002="                         "
t003="                         "
t004="                         "
t005="                         "
t006="                         "
t007="                         "
t008="                         "
t009="                         "
t010="ggggggggggggggggggggggggg"
t011="ggggggggggggggggggggggggg"
t012="ggggggggggmmmmmmmgggggggg"
t013="ggggggggggggggggggggggggg"
t014="ggggggggggggggggggggggggg"
t015="                         "
t016="                         "
t017="                         "
t018="                         "
t019="                         "
t020="                         "
t021="                         "
t022="                         "
t023="                         "
t024="                         "
r000="0000000000000000000000000"
r001="0000000000000000000000000"
r002="0000000000000000000000000"
r003="0000000000000000000000000"
r004="0000000000000000000000000"
r005="0000000000000000000000000"
r006="0000000000000000000000000"
r007="0000000000000000000000000"
r008="0000000000000000000000000"
r009="0000000000000000000000000"
r010="0000000000000r00000000000"
r011="0000000000000r00000000000"
r012="0000000000000r00000000000"
r013="rrrrrrrrrrrrrrrrrrrrrrrrr"
r014="0000000000000r00000000000"
r015="0000000000000000000000000"
r016="0000000000000000000000000"
r017="0000000000000000000000000"
r018="0000000000000000000000000"
r019="0000000000000000000000000"
r020="0000000000000000000000000"
r021="0000000000000000000000000"
r022="0000000000000000000000000"
r023="0000000000000000000000000"
r024="0000000000000000000000000"